state={
	id=1
	name="STATE_1"
	provinces={
		205 393 607 773 992 1080 1320 1415 2028 2096
		2339 2593 2618 2796 2835 2945 3162 3453 3519
		3568 3629 3651 3854 4130 4201 4590 5352 5630
		5686 5771 5904 5906 5914 5919 5920 5923 5927
		5929 5931 5935 5941 5953 5960 5965 5981 5990
		5995 6000 6011 6014 6029 
	}
	buildings_max_level_factor=1.000
        manpower=1
        state_category = town
}
