
state={
	id=93
	name="STATE_93"
	provinces={
		34 55 270 526 819 1174 1223 1272 1356 1460 1490 1968 2116 2353 
		2500 2511 2525 2762 3055 3078 3779 3781 4066 4282 4382 4391 4560
		4568 4804 5162 5171 5246 5426 5644 5699 5825 8249 8254 8261 8262 8269 8287
		8288 8289 8292 8330 8331 8336 8338 8352 8356 8357 8363 8368 8372
		8392 8396 8403 8410 8411 8429 8438 8447 8452 8471 8475 8478 8498
		8501 8504 8522 8531 
	}
	manpower=0
	buildings_max_level_factor=1.000
}
